10,10,10,10,10,10,10,10,10,10,10,10,10,10,10,10,10,10,10,10,10,10,10,10,10,10,10,10,10,10,
10, 0, 0, 0, 0, 0, 0, 0, 0, 0, 0, 0, 0, 0, 0, 0, 0, 0, 0, 0, 0, 0, 0, 0, 0, 0, 0, 0, 0,10,
10, 0, 0,10,10,10, 0,10,10,10,10,10, 0, 0,10,10, 0, 0, 0,10,10, 0, 0,10,10,10, 0, 0, 0,10,
10, 0,10, 0, 0, 0, 0, 0, 0,10, 0, 0, 0,10, 0, 0,10, 0,10, 0, 0, 0, 0,10, 0, 0, 0, 0, 0,10,
10, 0, 0,10,10, 0, 0, 0, 0,10, 0, 0, 0,10,10,10,10, 0,10, 0,10,10, 0,10,10,10, 0, 0, 0,10,
10, 0, 0, 0, 0,10, 0, 0, 0,10, 0, 0, 0,10, 0, 0,10, 0,10, 0, 0,10, 0,10, 0, 0, 0, 0, 0,10,
10, 0,10,10,10, 0, 0, 0, 0,10, 0, 0, 0,10, 0, 0,10, 0, 0,10,10, 0, 0,10,10,10, 0, 0, 0,10,
10, 0, 0, 0, 0, 0, 0, 0, 0, 0, 0, 0, 0, 0, 0, 0, 0, 0, 0, 0, 0, 0, 0, 0, 0, 0, 0, 0, 0,10,
10, 0, 0, 0, 0,10,10, 0, 0,10, 0, 0, 0, 0,10,10,10,10, 0, 0,10,10, 0, 0,10,10,10, 0, 0,10,
10, 0, 0, 0,10, 0, 0,10, 0,10, 0, 0, 0, 0,10, 0, 0, 0, 0,10, 0, 0,10, 0,10, 0, 0,10, 0,10,
10, 0, 0, 0,10, 0, 0, 0, 0,10, 0, 0, 0, 0,10,10,10,10, 0,10,10,10,10, 0,10,10,10,10, 0,10,
10, 0, 0, 0,10, 0, 0,10, 0,10, 0, 0, 0, 0,10, 0, 0, 0, 0,10, 0, 0,10, 0,10, 0,10, 0, 0,10,
10, 0, 0, 0, 0,10,10, 0, 0,10,10,10,10, 0,10,10,10,10, 0,10, 0, 0,10, 0,10, 0, 0,10, 0,10,
10, 0, 0, 0, 0, 0, 0, 0, 0, 0, 0, 0, 0, 0, 0, 0, 0, 0, 0, 0, 0, 0, 0, 0, 0, 0, 0, 0, 0,10,
10,10,10,10,10,10,10,10,10,10,10,10,10,10,10,10,10,10,10,10,10,10,10,10,10,10,10,10,10,10,

10,10,10,10,10,10,10,10,10,10,10,10,10,10,10,10,10,10,10,10,10,10,10,10,10,10,10,10,10,10,
10, 0, 0, 0, 0, 0, 0, 0, 0, 0, 0, 0, 0, 0, 0, 0, 0, 0, 0, 0, 0, 0, 0, 0, 0, 0, 0, 0, 0,10,
10, 0, 0, 0, 0, 0, 0, 0, 0, 0, 0, 0, 0, 0, 0, 0, 0, 0, 0, 0, 0, 0, 0, 0, 0, 0, 0, 0, 0,10,
10, 0, 0, 0, 0, 0, 0, 0, 0, 0, 0, 0, 0, 0, 0, 0, 0, 0, 0, 0, 0, 0, 0, 0, 0, 0, 0, 0, 0,10,
10, 0, 0, 0, 0, 0, 0, 0, 0, 0, 0, 0, 0, 0, 0, 0, 0, 0, 0, 0, 0, 0, 0, 0, 0, 0, 0, 0, 0,10,
10, 0, 0, 0, 0, 0, 0, 0, 0, 0, 0, 0, 0, 0, 0, 0, 0, 0, 0, 0, 0, 0, 0, 0, 0, 0, 0, 0, 0,10,
10, 0, 0, 0, 0, 0, 0, 0, 0, 0, 0, 0, 0, 0, 0, 0, 0, 0, 0, 0, 0, 0, 0, 0, 0, 0, 0, 0, 0,10,
10, 0, 0, 0, 0, 0, 0, 0, 0, 0, 0, 0, 0, 0, 0, 0, 0, 0, 0, 0, 0, 0, 0, 0, 0, 0, 0, 0, 0,10,
10, 0, 0, 0, 0, 0, 0, 0, 0, 0, 0, 0, 0, 0, 0, 0, 0, 0, 0, 0, 0, 0, 0, 0, 0, 0, 0, 0, 0,10,
10, 0, 0, 0, 0, 0, 0, 0, 0, 0, 0, 0, 0,-1, 0,-2, 0, 0, 0, 0, 0, 0, 0, 0, 0, 0, 0, 0, 0,10,
10, 0, 0, 0, 0, 0, 0, 0, 0, 0, 0, 0, 0, 0, 0, 0, 0, 0, 0, 0, 0, 0, 0, 0, 0, 0, 0, 0, 0,10,
10, 0, 0, 0, 0, 0, 0, 0, 0, 0,10,10,10,10,10,10,10,10,10,10, 0, 0, 0, 0, 0, 0, 0, 0, 0,10,
10, 0, 0, 0, 0, 0, 0, 0, 0, 0,10,10,10,10,10,10,10,10,10,10, 0, 0, 0, 0, 0, 0, 0, 0, 0,10,
10, 0, 0, 0, 0, 0, 0, 0, 0, 0,10,10,10,10,10,10,10,10,10,10, 0, 0, 0, 0, 0, 0, 0, 0, 0,10,
10,10,10,10,10,10,10,10,10,10,10,10,10,10,10,10,10,10,10,10,10,10,10,10,10,10,10,10,10,10,