10,10,10,10,10,10,10,10,10,10,10,10,10,10,10,10,10,10,10,10,10,10,10,10,10,10,10,10,10,10,
10, 0, 0, 0,10,30,30,30,30,30,30,10,30,30,30,30,30,30,30,30,30,30,30,30,30,30,30,30,30,10,
10, 0, 0, 0,10, 0, 0, 0, 0, 0, 0,10,30, 0, 0, 0, 0, 0, 0, 0, 0, 0, 0, 0, 0, 0, 0, 0,30,10,
10, 0,20, 0,10, 0, 0, 0, 0, 0, 0,10,30, 0, 0, 0,23, 0, 0, 0, 0, 0, 0, 0, 0, 0, 0, 0,30,10,
10, 0, 0, 0,10, 0, 0, 0, 0, 0, 0,10,30, 0, 0, 0, 0, 0, 0, 0, 0, 0, 0, 0, 0, 0, 0, 0,30,10,
10, 0, 0, 0,10, 0, 0, 0, 0, 0, 0,10,30, 0, 0, 0, 0, 0, 0, 0, 0, 0, 0, 0, 0, 0, 0, 0,30,10,
10, 0, 0, 0,10, 0, 0, 0, 0, 0, 0,10,30, 0, 0, 0, 0, 0, 0, 0, 0, 0, 0, 0, 0, 0, 0, 0,30,10,
10, 0, 0, 0,10, 0, 0, 0, 0, 0, 0,10,30, 0, 0, 0, 0, 0, 0, 0, 0, 0, 0, 0, 0, 0, 0, 0,30,10,
10,10,10,10,10,10,10,10,10,10, 0,10,30, 0, 0, 0, 0, 0, 0, 0, 0, 0, 0, 0, 0, 0, 0, 0,30,10,
10, 0, 0, 0, 0, 0, 0, 0, 0,10, 0,10,30, 0, 0, 0, 0, 0, 0, 0, 0, 0, 0, 0, 0, 0, 0, 0,30,10,
10, 0, 0, 0, 0, 0, 0, 0, 0,10, 0,10,10,10,10, 0, 0, 0,10,10,10,10,10, 0, 0, 0, 0, 0,30,10,
10, 0,21, 0, 0, 0, 0, 0, 0,10, 0,10,30,30,30, 0, 0, 0, 0, 0, 0, 0,10, 0, 0, 0, 0, 0,30,10,
10, 0, 0, 0, 0, 0, 0, 0, 0,10, 0,10,30, 0, 0, 0, 0, 0, 0, 0, 0, 0,10, 0, 0, 0, 0, 0,30,10,
10, 0, 0, 0, 0, 0, 0, 0, 0,10, 0,10,30, 0, 0, 0, 0, 0, 0, 0, 0, 0,10,30,30,30,30,30,30,10,
10,10,10,10,10,10,10,10,10,10,10,10,10,10,10,10,10,10,10,10,10,10,10,10,10,10,10,10,10,10,

10,10,10,10,10,10,10,10,10,10,10,10,10,10,10,10,10,10,10,10,10,10,10,10,10,10,10,10,10,10,
10, 0, 0, 0,10,30,30,30,30,10,30,30,30,30,30,30,30,30,30,30,30,30,30,30,30,30,30,30,30,10,
10, 0, 0, 0,10, 0, 0, 0, 0,10, 0,10,30, 0, 0, 0, 0, 0, 0, 0, 0, 0, 0, 0, 0, 0, 0, 0,30,10,
10, 0, 0, 0,10, 0, 0, 0, 0,10, 0,10,30, 0, 0, 0, 0, 0, 0, 0, 0, 0, 0, 0, 0, 0, 0, 0,30,10,
10, 0, 0, 0,10, 0, 0, 0, 0,10, 0,10,30, 0, 0, 0, 0, 0, 0, 0, 0, 0, 0, 0, 0, 0,-2, 0,30,10,
10, 0, 0, 0,10, 0, 0, 0, 0,10, 0,10,30, 0, 0, 0, 0, 0, 0, 0, 0, 0, 0, 0, 0, 0, 0, 0,30,10,
10, 0, 0, 0,10, 0, 0, 0, 0,10, 0,10,30, 0, 0, 0, 0, 0, 0, 0, 0, 0, 0, 0, 0, 0, 0, 0,30,10,
10, 0, 0, 0,10, 0, 0, 0, 0,10, 0,10,30, 0, 0, 0, 0, 0, 0, 0, 0, 0, 0, 0, 0, 0, 0, 0,30,10,
10, 0, 0, 0,10, 0, 0, 0, 0,10, 0,10,30, 0,20, 0, 0, 0, 0, 0, 0, 0, 0, 0, 0, 0, 0, 0,30,10,
10, 0, 0, 0,10, 0, 0, 0, 0,10, 0,10,30, 0, 0, 0, 0, 0, 0, 0, 0, 0, 0, 0, 0, 0, 0, 0,30,10,
10, 0, 0, 0,10, 0, 0, 0, 0,10, 0,10,10,10,10,10,10,10,10,10,10,10,10, 0, 0, 0, 0, 0,30,10,
10, 0, 0, 0,10, 0, 0, 0, 0,10, 0, 0, 0, 0, 0, 0, 0, 0, 0, 0, 0, 0,10, 0, 0, 0, 0, 0,30,10,
10, 0,-1, 0,10, 0, 0, 0, 0,10, 0, 0, 0, 0, 0, 0, 0, 0, 0, 0,21, 0,10, 0, 0, 0, 0, 0,30,10,
10, 0, 0, 0,10, 0, 0, 0, 0,10, 0, 0, 0, 0, 0, 0, 0, 0, 0, 0, 0, 0,10,30,30,30,30,30,30,10,
10,10,10,10,10,10,10,10,10,10,10,10,10,10,10,10,10,10,10,10,10,10,10,10,10,10,10,10,10,10,